http://partow.net/programming/bitmap/

24
12
12
111111111111
120000000001
100000000001
100000000001
100000000001
100005000001
100000000001
100000000001
100000000001
100000000001
100000000081
111111111111